111111111
100000001
10E0000P1
100000001
1C0000001
111111111
