111111111
100000001
10P000111
1E00000C1
111111111