111111111111111
1000E00000C0001
100010100010101
101000100010101
1P00000C00000C1
111111111111111