111111111111111
100000000000001
1000E00000C0001
100010100010101
100010010101001
1P00000C00000C1
100010000010001
101000100010011
111111111111111