1111111111
1000000001
1000ECP001
1000000001
1111111111